R 500 500
F 0,255,0    
C 255,0, 66
NO /OK1.xpm
SO /OK2.xpm
EA /OK3.xpm
WE /OK4.xpm
S /OK5.xpm

  11111 
 110N011
110000011
100111001
1001 1001
110111001
 10000011
 1111111
