R  200 200
F 0,255,0    
C 255,0, 66

NO /OK1.xpm
SO /OK2.xpm
EA /OK3.xpm
WE /OK4.xpm
S /OK5.xpm


111111111
100000001
100000001
100000001
100000001
1000W0001
111111111
