R   1000 1000
F 0,255,0    
C 255,0, 66

NO ./OK1



SO     ./OK2
EA ./OK3
WE ./OK4
S ./OK5


   11111 
  11W0011
 110000011
 10011101
 1001 1011
 110111021
  10000011
  1111111

