R 750     750     
F 153,102,0    
C 9,69,69   

NO ./images/carreg.xpm
SO images/carresve.xpm
EA images/carrese.xpm
WE images/carreh.xpm
S images/hp2.xpm



       
     
       
  1111111  11111    
  1000021  100001    
  1000001  102001    
  100000011100111  
  10E000000000001     
  100020000000001     
  100000111110001     
  1000001  120001     
  1111111  11111    
                     
