R  1400 1400 
F      153    ,102,    0    
C    69   ,  69   ,69      

NO       ./images/carreg.xpm      
SO images/carresve.xpm       
EA          images/carrese.xpm
WE images/carreh.xpm
S images/hp4.xpm

  111     
  1111111 
11210100111
1000000001 
10N00020001 
1020000001 
 11111111
  111


