R  200 200
F 0,255,0    
C 255,0, 66

NO ./images/north.xpm
SO ./images/south.xpm
EA ./images/east.xpm
WE ./images/west.xpm
S /OK5.xpm


1111111111
1000000001
1000000001
1000000001
1000000001
1000000001
1000N00001
1111111111
