R  500 500
F 220,100,0    
C 69,69,69

NO images/north2.xpm
SO images/south2.xpm
EA images/east2.xpm
WE images/west2.xpm
S images/soldier.xpm

11111111111
10000020001
10000020001
10000020001
10000000001
10000N00001
10000000001
11111111111
