R 750 750
F 153,102,0    
C 69,69,69

NO ./images/carreg.xpm
SO images/carresve.xpm
EA images/carrese.xpm
WE images/carreh.xpm
S images/hp2.xpm

  1111111  11111   
  1000001  120001   
  100000111120001   
  100002000011111   
  100020000000201   
  10N000111100001   
  1000001  120001   
  1111111  111111   
