R 1000 1000 

F 220,    100,0
C 69  ,   69, 69    

NO images/north2.xpm       
SO images/south2.xpm
EA images/east2.xpm
WE images/west2.xpm
S path_to_the_sprite_texture.xpm

        1111111111111111111111111
        1000000000110000000000001
        1011000001110000002000001
        1001000000000000000000001
111111111011000001110000000000001
100000000011000001110111111111111
11110111111111011100000010001
11110111 11111011101010010001
110000011101010111000N0010001
10002000000000001100000000001
10000000000000001101010010001
1100000111010101111101111000111
11110111 1110101 101111010001
11111111 1111111 111111111111
