R 500 500
F 220,100,0    
C 69,69,69

NO ./images/north2.xpm
SO images/south2.xpm
EA images/east2.xpm
WE images/west2.xpm
S images/soldier.xpm

  1111111  11111   
  1000001  120001   
  1000001  120001   
  1000011  100001   
  1000201  100201   
  10N0001  100001   
  1000001  120001   
  1111111  111111   
