R 15500 55500
F 220,100,0    
C 69,69,69

NO images/north2.xpm
SO images/south2.xpm
EA images/east2.xpm
WE images/west2.xpm
S images/soldier.xpm

11111111111
10000020001
10000020001
10000100001
100020N0201
10000000001
10000020001
11111111111
