SO images/south.xpm
WE images/west.xpm
EA images/east.xpm
S images/sprite.xpm
C 0,0,100
F 46,46,46
NO images/north.xpm
R 1920 1080

111111111111111111111111
100000000000000000000001
100000111111111100000001
100000000000000000000001
100000020000000000000011
1000000000002000W0200001
100000000200000000000001
100000000000000000000001
100000010000000001111111
100020000000000000000001
100000000000010000000001
100000200000000000000001
100000000000000000000001
100000000100000000000001
100000010000000000000001
100000000010021000000001
100000000000000000000001
100020000000000000000001
100000000000000000000001
111111111111111111111111
