SO images/south.xpm
WE images/west.xpm
EA images/east.xpm
S images/sprite.xpm
C 69,69,69
F 153,102,0
NO images/north.xpm
R 600 600

         1111111111111111111111111
         1000000000000000000000001
         1011000001110000002000001
         1001000000000000000000001
111111111011000001110000000000001
100000000011000000010111110011111
11110111111111011100000010001
11110111111111000001010010001
11000000110101011100000010001
10002000000000001100000000201
10000000000000001101010010001
11000001110101011111011110W0111
11110111 1110101 101111010001
11111111 1111111 111111111111
